1980
26
23 23 23 23 23 23 23 23 23 23 23 23 23 23 23 23 23 23 23 23 23 23 23 23 23 23 23 23 23 23 23 23 23 23 23 23 23 23 23 23 23 23 23 23 23 23 23 23 23 23 23 23 23 23 23 23 23 23 23 23 23 23 23 23 23 23 23 23 23 23 23 23 23 23 23 23 23 23 23 23 23 23 23 23 23 23 23 23 23 23 
23 23 23 23 23 23 23 23 23 23 23 23 23 23 23 23 23 23 23 23 23 23 23 23 23 23 23 23 23 23 23 23 23 23 23 23 23 23 23 23 23 23 23 23 23 23 23 23 23 23 23 23 23 23 23 23 23 23 23 23 23 23 23 23 23 23 23 23 23 23 23 23 23 23 23 23 23 23 23 23 23 23 23 23 23 23 23 23 23 23 
23 23 23 23 23 23 23 23 23 23 23 23 23 23 23 23 23 23 23 23 23 23 23 23 23 23 23 23 23 23 23 23 23 23 23 23 23 23 23 23 23 23 23 23 23 23 23 23 23 23 23 23 23 23 23 23 23 23 23 23 23 23 23 23 23 23 23 23 23 23 23 23 23 23 23 23 23 23 23 23 23 23 23 23 23 23 23 23 23 23 
23 23 23 23 23 23 23 23 23 23 23 23 23 23 23 23 23 23 23 23 23 23 23 23 23 23 23 23 23 23 23 23 23 23 23 23 23 23 23 23 23 23 23 23 23 23 23 23 23 23 23 23 23 23 23 23 23 23 23 23 23 23 23 23 23 23 23 23 23 23 23 23 23 23 23 23 23 23 23 23 23 23 23 23 23 23 23 23 23 23 
23 23 23 23 23 23 23 23 23 23 23 23 23 23 23 23 23 23 23 23 23 23 23 23 23 23 23 23 23 23 23 23 23 23 23 23 23 23 23 23 23 23 23 23 23 23 23 23 23 23 23 23 23 23 23 23 23 23 23 23 23 23 23 23 23 23 23 23 23 23 23 23 23 23 23 23 23 23 23 23 23 23 23 23 23 23 23 23 23 23 
23 23 23 23 23 23 23 23 23 23 23 23 23 23 23 23 23 23 23 23 23 23 23 23 23 23 23 23 23 23 23 23 23 23 23 23 23 23 23 23 23 23 23 23 23 23 23 23 23 23 23 23 23 23 23 23 23 23 23 23 23 23 23 23 23 23 23 23 23 23 23 23 23 23 23 23 23 23 23 23 23 23 23 23 23 23 23 23 23 23 
23 23 23 23 23 23 23 23 23 23 23 23 23 23 23 23 23 23 23 23 23 23 23 23 23 23 23 23 23 23 23 23 23 23 23 23 23 23 23 23 23 23 23 23 23 23 23 23 23 23 23 23 23 23 23 23 23 23 23 23 23 23 23 23 23 23 23 23 23 23 23 23 23 23 23 23 23 23 23 23 23 23 23 23 23 23 23 23 23 23 
23 20 19 23 23 23 23 23 23 23 23 23 23 23 23 23 23 20 18 18 18 18 18 18 18 18 18 18 19 23 23 23 23 23 23 23 23 20 18 18 18 18 18 18 18 18 18 18 18 18 18 18 18 18 18 18 18 18 19 23 23 23 23 23 23 23 23 23 23 23 23 23 20 18 18 18 18 18 18 19 23 23 23 23 23 23 23 23 23 23 
23 5 0 23 23 23 23 23 23 23 23 23 23 23 23 23 23 5 0 0 0 0 0 0 0 0 0 0 4 23 23 23 23 23 23 23 23 5 0 0 0 0 0 0 0 0 0 0 0 0 0 0 0 0 0 0 0 0 0 19 23 23 23 23 23 23 23 23 23 23 23 23 5 0 0 0 0 0 0 4 23 23 23 23 23 23 23 23 23 23 
23 5 0 18 18 18 18 18 19 23 23 23 23 23 23 23 23 5 0 0 0 0 0 0 0 0 0 0 0 18 18 18 18 18 18 18 18 0 0 0 0 0 0 0 0 0 0 0 0 0 0 0 0 0 0 0 0 0 0 4 23 23 23 23 23 23 23 23 23 23 23 23 5 0 0 0 0 0 0 0 18 18 18 19 23 23 23 23 23 23 
23 5 0 0 0 0 0 0 0 18 18 18 18 18 18 18 18 0 0 0 0 0 0 0 0 0 0 0 0 0 0 0 0 0 0 0 0 0 0 0 0 0 0 0 0 0 0 0 0 0 0 0 0 0 0 0 0 0 0 4 23 23 23 23 23 23 23 23 23 23 23 23 5 0 0 0 0 0 0 0 0 0 0 4 23 23 23 23 23 23 
23 5 0 0 0 0 0 0 0 0 0 0 0 0 0 0 0 0 0 0 0 0 0 0 0 0 0 0 0 0 0 0 0 0 0 0 0 0 0 0 0 0 0 0 0 0 0 0 0 0 0 0 0 0 0 0 0 0 0 4 23 23 20 19 23 23 23 20 18 18 18 18 0 0 0 0 0 0 0 0 0 0 0 4 23 23 23 23 23 23 
23 5 0 0 0 0 0 0 0 0 0 0 0 0 0 0 0 0 0 0 0 0 0 0 0 0 0 0 0 0 0 0 0 0 2 22 22 3 0 0 0 0 0 0 0 0 0 0 0 0 0 0 0 0 2 22 3 0 0 4 23 23 5 0 18 18 18 0 0 0 0 0 0 0 0 0 0 0 0 0 0 0 0 4 23 23 23 23 23 23 
23 5 0 0 0 0 0 0 0 0 0 0 0 0 0 0 0 0 0 0 0 0 0 0 0 0 0 0 0 0 0 0 0 0 4 23 23 5 0 0 0 0 0 0 0 0 0 0 0 0 0 0 0 0 4 23 5 0 0 4 23 23 5 0 0 0 0 0 0 0 0 0 0 0 0 0 0 0 0 0 0 0 0 4 23 23 23 23 23 23 
23 5 0 0 0 0 0 0 0 0 0 0 0 0 0 0 0 0 0 24 25 26 0 0 0 0 0 0 0 0 0 0 0 0 4 23 23 5 0 0 0 0 0 0 0 0 0 0 0 0 0 0 0 0 4 23 5 0 0 0 18 18 0 0 0 0 0 0 0 0 0 0 0 0 0 0 0 0 0 0 0 0 0 4 23 23 23 23 23 23 
23 5 0 0 0 0 0 0 0 0 0 0 0 0 0 0 0 0 0 0 0 0 0 0 0 0 0 0 0 0 24 25 26 0 2 22 22 22 22 22 22 22 22 22 22 22 22 22 22 22 22 22 22 22 22 23 5 0 0 0 0 0 0 0 0 0 0 0 0 0 0 0 0 0 0 0 0 0 0 0 0 0 0 4 23 23 23 23 23 23 
23 5 0 0 0 0 0 0 0 0 0 0 0 2 22 22 3 0 0 0 0 0 0 0 0 0 0 0 0 0 0 0 0 0 4 23 23 23 23 23 23 23 23 23 23 23 23 23 23 23 23 23 23 23 23 23 5 0 0 8 22 22 0 0 0 0 0 0 0 0 0 0 0 0 0 0 0 0 0 0 0 0 0 4 23 23 23 23 23 23 
23 5 0 0 0 0 0 0 0 0 0 0 0 0 23 23 5 0 0 0 0 0 0 0 0 0 0 0 0 0 0 0 0 0 4 23 23 23 23 23 23 23 23 23 23 23 23 23 23 23 23 23 23 23 23 23 5 0 0 23 23 23 0 0 0 0 0 0 0 0 0 0 0 0 0 0 0 0 0 0 0 0 0 4 23 23 23 23 23 23 
23 5 0 0 0 0 0 0 0 0 0 0 0 0 23 23 5 0 0 0 0 0 0 0 24 25 26 0 0 0 0 0 0 0 4 23 23 23 23 23 23 23 23 23 23 23 23 23 23 23 23 23 23 23 23 23 5 0 0 23 23 23 0 0 0 0 0 0 0 0 0 0 0 0 0 0 0 0 0 0 0 0 0 4 23 23 23 23 23 23 
23 5 0 0 0 0 0 0 0 0 0 0 0 0 23 23 5 0 0 0 0 0 0 0 0 0 0 0 0 0 0 0 0 0 4 23 23 23 23 23 23 23 23 23 23 23 23 23 23 23 23 23 23 23 23 23 5 0 0 23 23 23 0 0 0 0 0 0 0 0 0 0 0 0 0 0 0 0 0 0 0 0 0 4 23 23 23 23 23 23 
22 22 22 22 22 22 22 22 22 22 22 22 22 22 23 23 5 0 0 0 0 0 0 0 0 0 0 0 0 0 0 0 0 0 4 23 23 23 23 23 23 23 23 23 23 23 23 23 23 23 23 23 23 23 23 23 5 0 0 23 23 23 0 0 0 0 0 0 0 0 0 0 0 0 0 0 0 0 0 0 0 0 0 4 23 23 23 23 23 23 
23 23 23 23 23 23 23 23 23 23 23 23 23 23 23 23 5 0 0 0 0 0 0 0 0 0 0 0 0 0 0 0 0 0 4 23 23 23 23 23 23 23 23 23 23 23 23 23 23 23 23 23 23 23 23 23 5 0 0 23 23 23 23 23 23 23 23 23 23 23 23 23 23 23 23 23 23 23 23 23 23 23 23 23 23 23 23 23 23 2